##########B#
#   #  #   #
##    #    #
# ####### ##
# #   #    #
# # # #  # #
#   #    # #
#A##########