+-+-+-+-+-+-+-+-+-+-+-+-+-+-+-+-+-+-+-+-+
A     |       |   |     |   |     |     |
+ +-+ + +-+-+ + + + +-+ + + + +-+ + +-+ +
| |   | | |   | | |   | | | | | | |   | |
+ + +-+ + + +-+ + +-+-+ + + + + + +-+ + +
| |     | |   | |   |   | |   | |   | | |
+ +-+-+-+ +-+ + + + + +-+ +-+-+ +-+ + +-+
|     | |     | | |   |   |   |   | |   |
+-+-+ + +-+-+-+-+ +-+-+ +-+ + +-+ + + + +
|     |         |     | |   | |       | |
+ +-+-+-+-+-+-+ + +-+ + +-+-+ +-+ +-+-+ +
|           |   | |   |     |   | |     |
+ +-+-+-+-+ + +-+ + +-+-+-+ +-+ + + +-+-+
|   |   | |     | | |   | |   | | | |   |
+-+ + + + +-+ + + + + + + +-+ + + + +-+ +
|   | |   |   | | |   | | | | |   |   | |
+ +-+ +-+-+ +-+-+ +-+-+ + + + +-+-+-+ + +
| |   |   | |   | |     |   |       | | |
+ + +-+ + + + + + + +-+-+ + + +-+-+ + + +
|       | |   |   |       |   |     |   B
+-+-+-+-+-+-+-+-+-+-+-+-+-+-+-+-+-+-+-+-+